9
8
___@@@@_
@@@@__@_
@__+__@@
@_@+@__@
@__+___@
@o@@@__@
@o@@@@_@
@o_i___@
@@@@@@@@
