6
10
______@@@@
@@@@@@@_o@
@_+_+_++_@
@___i_ooo@
@@@___@@@@
__@@@@@___
