6
10
_@@@@@@@@@
_@__@@___@
@@__*__@_@
@_o+@*i__@
@___*___@@
@@@@@@@@@_
