8
8
__@@@@@_
@@@___@@
@_++oo_@
@__oi@_@
@@_@___@
_@_+*_@@
_@@@__@_
___@@@@_
