9
9
_____@@@@
_@@@@@__@
_@_+_+__@
_@o@_@o_@
_@_+i+_@@
@@o@_@o@@
@__*_*__@
@___@___@
@@@@@@@@@
