7
9
_____@@@@
____@@__@
___@@_o_@
@@@@_+__@
@_+_+oi@@
@__o__@@_
@@@@@@@__
