9
8
__@@@@__
@@@oi@@@
@______@
@_*oo@_@
@@_@++_@
_@____@@
_@@+@_@_
__@___@_
__@@@@@_
