9
9
__@@@@@__
__@___@@@
@@@*@_+_@
@_+_i_@_@
@_@_oo__@
@_o_@+@@@
@@+o__@__
_@__@@@__
_@@@@____
