8
9
__@@@@@__
@@@___@@_
@__+@__@_
@__oio+@@
@@o@_@__@
_@_+____@
_@@__@@@@
__@@@@___
