8
8
__@@@@__
@@@__@@@
@___o__@
@__+_+_@
@@o@$@o@
_@_+_+_@
_@@@__@@
___@@@@_
