9
10
__@@@@____
@@@__@____
@____@@___
@__@__@@@_
@@_o_o_o@_
@@+@@o@+@@
@_+__i_+_@
@___@@___@
@@@@@@@@@@
