8
7
@@@@@__
@___@@@
@o@+__@
@_i+*_@
@__+__@
@@o@o@@
_@___@_
_@@@@@_
