6
17
@@@@@@@@@@@@@@@@@
@__@__@__@__@___@
@o+___@__@o+____@
@__@o+_o+___@___@
@_i@__@__@__@___@
@@@@@@@@@@@@@@@@@
