9
8
_@@@@@__
_@___@@@
@@_@+_i@
@_o_+__@
@ooo@+@@
@_@__+_@
@__@___@
@@___@@@
_@@@@@__
