7
9
@@@@_@@@@
@__@@@__@
@_+_*_+_@
@___$___@
@@@_o+@@@
__@_o_@__
__@@@@@__
