8
9
__@@@@@@@
_@@__@__@
_@_*_*__@
@@___@__@
@__*@$_@@
@_____+@_
@@@@@__@_
____@@@@_
