8
8
__@@@@__
__@__@@@
_@@_o__@
@@i+++_@
@_o_o_@@
@___@@@_
@__@@___
@@@@____
