9
8
____@@@@
@@@@@__@
@___*__@
@_*o@__@
@@_@@_@@
@_+____@
@_i@___@
@__@@@@@
@@@@____
