9
9
_____@@@@
___@@@__@
_@@@_oo_@
_@_++@__@
@@_@_@i@@
@__*____@
@___@___@
@@@@@@__@
_____@@@@
