9
8
@@@@@@@@
@___@__@
@______@
@@_@o_o@
@____@@@
@_@_*_@_
@_++@_@_
@@@__i@_
__@@@@@_
