8
8
___@@@@_
@@@@__@_
@_+___@_
@__o@_@@
@@_@o__@
@_i__+_@
@___@@@@
@@@@@___
