9
8
_@@@@@__
_@___@@_
@@o@+_@@
@_+____@
@o_o@+_@
@@@_i_@@
__@_@_@_
__@___@_
__@@@@@_
