7
8
__@@@@__
@@@__@@@
@___*+_@
@_@__@i@
@_@_*o_@
@___@@@@
@@@@@___
