9
9
____@@@@_
_@@@@__@_
@@_+___@_
@__@_@+@_
@oio___@@
@@_@_@__@
_@______@
_@__@@@@@
_@@@@____
