9
11
______@@@@_
@@@@@@@__@_
@________@_
@__+_@o@_@_
@_++@@_@_@@
@@@_o_i___@
__@@@__@__@
____@@o__@@
_____@@@@@_
