9
9
____@@@@_
_@@@@__@_
@@_+___@_
@__@_@+@_
@oioo__@@
@@_@_@__@
_@___+__@
_@__@@@@@
_@@@@____
