8
9
_@@@@@___
@@___@@@_
@_o_o__@_
@_@_@@_@@
@____++i@
@@@_@___@
__@___@@@
__@@@@@__
