9
8
@@@@@@@@
@___@__@
@______@
@@_@o__@
@____@@@
@_@_o_@_
@_++@_@_
@@@__i@_
__@@@@@_
