9
8
_@@@@@__
_@___@@_
@@_@+_@@
@_+____@
@o_o@__@
@@@_i_@@
__@_@_@_
__@___@_
__@@@@@_
