9
7
@@@@@__
@___@@@
@_o___@
@@_+__@
@@@@+@@
@__+_@@
@_i___@
@@@o_o@
__@@@@@
