8
9
_@@@@@___
@@___@@@_
@_o_o_o@_
@_@_@@_@@
@____++i@
@@@_@_+_@
__@___@@@
__@@@@@__
