9
10
____@@@@@_
___@@___@@
__@@_o@__@
_@@___i__@
@@__*_@__@
@__+_@@@@@
@_*_@@____
@__@@_____
@@@@______
