8
8
___@@@@_
@@@@__@_
@_+_+_@_
@__o@_@@
@@_@o__@
@_i__+_@
@o__@@@@
@@@@@___
