7
9
_@@@@@@@_
_@__@__@@
@@_**+o_@
@___@___@
@___i_@@@
@__@@@@__
@@@@_____
