8
8
__@@@@@_
@@@___@_
@_+_@_@@
@_@__o_@
@____@_@
@@+@o__@
_@i__@@@
_@@@@@__
