8
8
__@@@@@_
@@@___@_
@_+_@_@@
@_@__o_@
@_o__@_@
@@+@o+_@
_@i__@@@
_@@@@@__
