9
7
__@@@@_
_@@__@_
@@___@@
@__*+_@
@_@_@i@
@__*o_@
@@@__@@
__@__@_
__@@@@_
