9
8
_@@@@___
_@__@@@@
_@_____@
_@_@o__@
@@*@@+@@
@______@
@_@_i__@
@____@@@
@@@@@@__
