8
8
@@@@@___
@___@@__
@_@__@@@
@___*+_@
@@@__@i@
__@_*o_@
__@__@@@
__@@@@__
