9
8
__@@@@@_
@@@___@_
@_____@_
@__@o@@@
@@i+++_@
_@o@o@_@
_@_____@
_@__@@@@
_@@@@___
