9
11
______@@@@_
@@@@@@@__@_
@________@_
@__+_@o@_@_
@__+@@_@_@@
@@@___i___@
__@@@__@__@
____@@o__@@
_____@@@@@_
