7
9
_@@@@@@@_
@@__@__@_
@__**+o@@
@___@___@
@@@_i___@
__@@@@__@
_____@@@@
