9
8
@@@@____
@__@@@@_
@_____@_
@_____@_
@@@_@@@_
@_+++_@@
@_oooi_@
@@@@___@
___@@@@@
