9
8
____@@@@
@@@@@__@
@___+__@
@__o@__@
@@_@@_@@
@______@
@_i@___@
@__@@@@@
@@@@____
