8
7
__@@@@_
_@@__@_
@@_o_@@
@i+++_@
@o_o@_@
@_@___@
@___@@@
@@@@@__
