8
8
_@@@@@__
_@___@__
@@+@_@@@
@___+i_@
@_@__@_@
@_@o_o_@
@___@@@@
@@@@@___
