8
8
_@@@@@__
_@___@__
@@+@_@@@
@__o+i_@
@_@__@_@
@_@oo+_@
@___@@@@
@@@@@___
