9
8
@@@@____
@__@@@@_
@_____@_
@_____@_
@@@_@@@_
@_++__@@
@_o_oi_@
@@@@___@
___@@@@@
